32 32
7 1 2 3 4 5 6 7 1 2 3 4 5 6 7 1 2 3 4 5 6 7 1 2 3 4 5 6 7 1 2 6
4 0 0 0 0 0 0 0 0 1 0 0 0 0 0 0 0 0 0 0 0 0 0 0 0 0 0 0 0 0 0 1
3 0 0 0 0 0 0 0 0 3 0 0 0 0 0 0 0 0 0 0 0 0 0 0 0 0 0 0 0 0 0 1
2 0 0 0 0 0 0 0 0 1 0 0 0 0 0 0 0 0 1 1 1 1 1 1 1 1 1 1 1 0 0 1
7 3 2 1 3 2 1 0 1 1 0 3 1 1 1 1 0 0 1 0 0 0 0 0 0 0 0 1 1 0 0 1
6 5 0 0 0 1 0 0 0 0 0 4 0 0 0 2 0 0 1 0 0 0 0 0 0 0 0 1 1 0 0 1
5 0 5 0 0 3 0 0 0 0 0 5 0 0 0 1 0 0 1 0 0 0 0 0 0 0 0 1 1 0 0 1
4 1 0 0 1 2 0 0 0 0 0 6 0 0 0 0 0 0 1 0 0 1 2 1 1 0 0 0 0 0 0 1
3 0 0 3 0 0 0 0 0 0 0 7 0 0 0 0 0 0 1 0 0 1 1 6 6 0 0 0 0 0 0 1
2 0 1 0 0 0 0 0 0 0 0 1 0 0 0 0 0 0 1 0 0 0 1 6 6 1 1 1 1 0 0 1
1 0 0 0 0 0 5 0 5 0 0 1 0 0 0 0 0 0 1 0 0 0 1 6 6 1 6 6 1 0 0 1
7 1 2 1 3 1 2 0 2 1 3 1 0 0 0 0 0 0 0 0 0 0 2 1 1 5 6 6 1 0 0 0
6 0 0 0 0 0 0 0 0 0 0 0 0 0 0 0 0 0 0 0 0 0 0 0 0 1 6 6 1 0 0 0
5 0 0 0 0 0 0 0 0 0 0 0 0 0 0 0 0 0 0 0 0 0 0 0 0 1 6 6 1 0 0 0
4 0 0 0 0 0 0 0 0 0 0 0 0 0 0 0 0 0 0 0 0 0 0 0 0 2 1 1 1 0 0 0
3 0 0 0 0 0 0 0 0 0 0 0 0 0 0 0 0 0 0 0 0 0 0 0 0 0 0 0 0 0 0 0
2 0 0 0 0 0 0 0 0 0 0 0 0 0 0 0 0 3 0 0 0 1 0 0 0 0 0 0 0 0 0 0
1 0 0 0 0 1 1 0 1 1 0 0 0 0 0 0 0 2 0 0 0 0 2 0 0 0 0 0 1 2 1 2
7 0 0 0 1 1 0 0 0 1 1 0 0 0 0 0 0 1 0 0 0 0 0 3 0 0 0 0 1 0 0 1
6 0 0 0 1 0 0 0 0 0 1 0 0 0 0 0 0 2 0 0 0 0 0 0 4 0 0 0 1 0 0 1
5 0 0 0 2 0 0 0 0 0 2 0 0 0 0 0 0 3 0 0 0 0 0 5 0 5 0 0 3 0 0 1
4 0 0 0 1 0 0 0 0 0 1 0 0 0 0 0 0 0 0 0 0 0 6 0 0 0 6 0 2 0 0 1
3 0 0 0 1 1 0 0 0 1 1 1 2 0 0 0 0 0 0 0 0 7 0 0 0 0 0 0 2 0 0 1
0 0 0 0 0 1 1 3 1 1 0 0 1 0 0 0 0 0 0 0 0 0 0 0 0 0 0 0 4 1 0 1
0 0 0 0 0 0 1 2 1 0 0 0 1 0 9 0 0 0 0 0 0 0 0 1 3 0 0 0 0 0 0 1
0 0 0 0 0 0 0 0 0 0 0 0 3 0 0 0 0 0 0 0 0 0 0 2 2 0 0 0 0 0 0 1
0 0 0 0 0 0 0 0 0 0 0 0 1 0 0 0 0 0 0 0 0 0 0 0 0 0 0 0 0 0 0 1
0 0 0 0 0 0 0 0 0 0 0 0 1 0 0 0 2 3 2 4 2 0 0 0 0 0 0 0 0 0 0 1
0 0 0 0 0 0 0 0 0 0 0 0 0 0 0 0 0 0 0 0 0 0 0 0 0 0 0 0 0 0 0 1
3 0 0 0 0 0 0 0 0 0 0 0 0 0 0 0 0 0 0 0 0 0 0 0 0 0 0 0 0 0 0 1
2 0 0 0 0 0 0 0 0 0 0 0 0 0 0 0 0 0 0 0 0 0 0 0 0 0 0 0 0 0 0 1
7 1 2 3 4 5 6 7 1 2 3 4 0 0 0 0 0 0 0 5 6 7 1 2 3 4 5 6 7 1 2 6

